----.-----------
----.------.----
---....-.......-
---.-------.-.--
--............--
--------..-.----
-.......---.----
-.-----.......--
-.--------------
