----.----
-.......-
-.-----.-
-.......-
----.----
----.----
----.----