------------------.------------------
------------------.------------------
------------------.------------------
------------------.------------------
------------------.------------------
------------------.------------------
-...................................-
------.-----------------------.------
------.-----------------------.------
------.-----------------------.------
-...................................-
------------------.------------------
------------------.------------------
------------------.------------------
------------------.------------------
------------------.------------------
------------------.------------------
-...................................-
------.-----------------------.------
------.-----------------------.------
------.-----------------------.------
-...................................-
------------------.------------------
------------------.------------------
------------------.------------------
------------------.------------------
------------------.------------------
------------------.------------------
-...................................-
------.-----------------------.------
------.-----------------------.------
------.-----------------------.------
-...................................-
------------------.------------------
------------------.------------------
------------------.------------------
------------------.------------------
------------------.------------------
------------------.------------------
------------------.------------------
------------------.------------------
