-------.-------
-.............-
---.-------.---
-.............-
-------.-------
-------.-------
-.............-
---.-------.---
-.............-
-------.-------
-------.-------
-.............-
---.-------.---
-.............-
-------.-------
